-3 4 11 3 
-11 4 3 3 
-3 4 10 0 
-10 4 3 0 
-3 4 9 0 
-9 4 3 0 
-3 4 8 0 
-8 4 3 0 
-5 2 5 0 
-4 2 5 0 
-5 2 4 0 
-3 2 5 0 
-5 2 3 0 
-2 2 5 0 
-5 2 2 0 
-5 2 2 0 
3 5 6 0 
-2 2 4 0 
-4 2 2 0 
-6 5 -3 1 
-1 2 4 0 
-2 2 3 0 
-3 2 2 0 
-4 2 1 0 
-1 2 3 0 
-3 2 1 0 
-1 1 1 1 
0 1 1 0 
-1 1 0 0 
0 1 0 0 
