-2 2 -5 0 
-2 2 -4 0 
-1 2 -5 0 
-2 2 -3 0 
-1 2 -4 0 
0 2 -5 0 
-2 2 -2 0 
-1 2 -3 0 
0 2 -4 0 
1 2 -5 0 
0 2 -3 0 
1 2 -4 0 
2 2 -5 0 
2 2 -4 0 
3 2 -5 0 
3 2 -4 0 
4 2 -5 2 
-1 1 0 0 
4 2 -4 0 
0 1 0 0 
1 1 0 0 
7 2 -6 3 
2 1 0 0 
3 1 0 1 
6 0 -1 0 
7 0 -1 0 
9 0 -3 0 
8 0 -1 0 
9 0 -2 0 
9 0 -1 0 
